FB – Facebook
IG – Instagram
LI – LinkedIn
YT – YouTube
TW – Twitter
DM – Direct message
MT – Modified tweet
PM – Private message
RT – Retweeting them
B2B – Business to business
B2C – Business to consumer
CMGR – Community manager
CMS – Content management system
CPC – Cost per click
CPM – cost per mille
CR – Conversion rate
CRO – Conversion rate optimization
CTA – Call to action
CTR – Click through rate
SMP – Social media platform
ROI – Return on investment
SMM – Social media marketing
SoLoMo – Social local and mobile
SMO – Social media optimization
SRP – Social relationship platform
TOS – Terms of service
UGC – User-generated content
CX – Customer experience
API – Application programming interface
ESP – Email service provider
GA – Google Analytics
ISP – Internet service provider
PV – Page views
RSS – rich site summary
SaaS – Software as a service
SEO – Search engine optimization
SEM – Search engine marketing
SOV – Share of voice
UI – User interface
URL – Uniform resource locator
UV – Unique views
UX – User experience
AFAIK – As far as I know
AMA – Ask me anything
BRB – Be right back
BTS – Behind the scenes
BTW – By the way
BTAIM – Be that as it may
DAE – Does anyone else 
DYK – Did you know
ELI5 – Explain like I’m five
FBO – Facebook official
FBF – Flashback Friday
FF – Follow Friday
FOMO – Fear of missing out
FTFY – Fixed that for you
FTW – For the win
FYI – For your information
G2G – Got to go
GTG – Got to go
GG – Good game
GTR – Got to run
HBD – Happy birthday
HIFW – How I feel when
HMB – Hit me back
HMU – Hit me up
HT – Hat tip
HTH – happy to help
ICYMI – In case you missed it
IDC – I do not care
IDK – I do not know
IKR – I know right
ILY – I love you
IMHO – In my humble opinion
IMO – In my opinion
IRL – In real life
JK – Just kidding
LMAO – Laughing my ass off
LMK – Let me know
LMS – Like my status
LOL – Laughing out loud
MCM – Man crush Monday
MFW – My face when
MTFBWY – May the Force be with you
NBD – No big deal
NM – Not much
NSFW – Not safe for work
NVM – Never mind
OH – Used as context for quotes
OMW – On my way
OOTD – Outfit of the day
OP – Original poster
OTP – One true pairing
PPL – People
ROFL – Rolling on the floor laughing
ROFLMAO – Rolling on the floor laughing my ass off
SFW – Safe for work
TBT – Throwback Thursday
SMH – Shaking my head
TBH – To be honest
TBBH – To be brutally honest
TFW – That feeling when
TGIF – Thank God it is Friday
TIL – Today I learned
TL – Too long
DR – didn’t read
TMI – Too much information
WBU – What about you
WBW – Way back Wednesday
WFH – Work from home
YOLO – You only live once
Cray – crazy
Fam – family
On fleek – On point
Yaas – Yes
thnx – Thanks
thx – Thanks
TY – Thank You
mp3 – sound























